XXXXXXXX
X111111X
X100001X
X100N01X
X100001X
X111111X
XXXXXXXX