
111111111111111111111
1P000000000000C0000E1
101100100110111011101
101010101000100010101
101010100100100010101
101010100010100010101
101100101100111011101
100000000000000000001
111111111111111111111

