EA ./textures/wood.xpm
NO ./textures/mossy.xpm
SO ./textures/eagle.xpm
C 0,100,200

WE ./textures/greystone.xpm
F 125,120,120


 1111111111 111111111111111111
 1001000001 11101000000001
 1011000001 11111010000001
 1001000001 100000010N0001
11111111111 100001110000011111111
10000000011 10001110111111111
11110111111 11011100000010001
11110111111 111011101010010001
11000000001 100000000000000001
11110111111 11011101010010001
11111111111 11011101010010001
11111111111 111111111111111111
