NO ./textures/mossy.xpm
SO ./textures/eagle.xpm
EA ./textures/wood.xpm
WE ./textures/greystone.xpm


F     125,120,120
C 0,100,200

 1111111111111111111111111
 1001000001110000000000001
 10110000011100N0000000001
 1001000001000000000000001
11111111111000001110000011111111
10000000001100000111011111111
11110111111111011100000010001
11110111111111011101010010001
11000000000000000000000000001
11110111111111011101010010001
11111111111111011101010010001
11111111111111111111111111111

