NO ./path_to_the_north_texture
SO ./path_to_the_south_texture
WE ./path_to_the_west_texture
EA    ./path_to_the_east_texture
F     220,100,0
C 225,30,0



        1111111111111111111111111
        1000000000110000000000001
        1011000001110000000000001
        10010N0000000000000000001
111111111110000011100000000000001
100000000011000001110111100011111
11110111111111011100000010001
11110111111111011101010010001
10000001101010011000000100001
10000000000000011000000100001
11000000000000001101011110001
11000001110100000000000000001
11110111111100011101111110001
11111111111111111111111111111