EA ./textures/wood.xpm
NO ./textures/mossy.xpm
SO ./textures/eagle.xpm
C 0,100,200

WE ./textures/greystone.xpm
F 125,120,120


 11111111111111111111111111111111
 10010000000000000000000001N00001
 10110000000000100000000001000001
 10010000000000000000100000000001
111111111100000000000000000111001
100000000100000100000010001110111
111101111100000000000000001100001
111101111100000000000010001101011
110000000000000000110000000000001
111101111100000100000000001101011
111111111100000000000000001101001
11111111111111111111111111111111111
