NO ./path_to_the_north_texture
SO ./path_to_the_south_texture
WE ./path_to_the_west_texture
EA ./path_to_the_east_texture
F     220,100,0
C 225,30,0

 1111111111111111111111111
 1000000000110000000000001
 1011000001110000000000001
 1001000000000000000000001
11111111111000001110000011111111
10000000001100000111011111111
11110111111111011100000010001
11110111111111011101010010001
1100000000000000110101111N001
11110111111111011101010010001
11110111111111011101010010001
