NO ./path_to_the_north_texture
SO ./path_to_the_south_texture
WE ./path_to_the_west_texture
F 220,2,20
EA ./path_to_the_east_texture
C 225,0,254

   11111111111111111111111111 
  111000000000110000000000001 
11101100000111000000000000111 
1001000000000000000000001111 
1111111111100000111000001111111 
1000000000110000111000000000011111111 
11110111111111011100000010001
11110111111111011101010010001 
1100000000000000000000000N001 
11110111111111011101010010001 
11111111111111011101100010001 
11111111111111111111111111111 