EA ./textures/wood.xpm
NO ./textures/mossy.xpm
SO ./textures/eagle.xpm
C 0,100,200

WE ./textures/greystone.xpm
F 125,120,120


 1111111111111111111111111111
 100100000111101000000001
 101100000111111010000001
 1001000001100000010N0001
11111111111100001110000011111111
1000000001110001110111111111
11110111111110111000000100011111
11110111111111011101010010001
11111111111111111111111111111
11111111111111111111111111111
11000000001100000000000000001
1111011111111011101010010001
111111111111011101010010001
11111111111111111111111111111
