EA ./textures/barrel.xpm
NO ./textures/bluestone.xpm
SO ./textures/greenlight.xpm
WE ./textures/pillar.xpm
C 0,100,200
F 125,120,120

111111111111111111
101010101010101011
100000000000000001 
100011000011100001
100111100011110001
101101100011011001
100011000011001101
100110000011011101
101100000011111001
101111100011100001
10000000N000000001
101010101010101011
111111111111111111