EA ./textures/bluestone.xpm
NO ./textures/colorstone.xpm
SO ./textures/eagle.xpm
WE ./textures/redbrick.xpm
C 0,100,200
F 125,120,120

111111111111111111
101010101010101011
100000000000000001
100000110000111001
100001110001101101
100011110000001101
100110110000011001
101100110000110001
101111110001100001
100000110001111101
100000000N00000001
101010101010101011
111111111111111111