EA ./textures/purplestone.xpm
NO ./textures/colorstone.xpm
SO ./textures/bluestone.xpm
WE ./textures/redbrick.xpm
C 0,10,200
F 125,120,120

111111111111111111111111111111111
11000100000000010001111011000101N
100101001011011100110000101011011 
110100000100101011011101010100101
100100100111101011001001000110001
101101100001000001111011111110101
111111111111111111111111111111111
111111111111111111111111111111111
111100101111110100101000001000001
110001100001100110111011101001101
100101101011110100110001001111111
101101101000100101110011011000001
100100000000100100010010011001101
110111010110000101000010011001101
111111111111111111111111111111111
