EA ./textures/purplestone.xpm
NO ./textures/colorstone.xpm
SO ./textures/eagle.xpm
WE ./textures/redbrick.xpm
C 0,10,200
F 125,120,120

111111111111111111111111111111111
110001000000000100111110110001011
1001010N0100001100110000011011011
110100000100101001111101010000001
100100110111101011111001000110001
101101100001000001100011011110101
111111111111111111101111011111111
111111111111111111101111011111111
111100101111110100101000001000001
110001100001100110111011101001101
100101101011110100110001001111111
101101101000100101110011011000001
111111111111111111111111111111111
100100000000100101000000011000001
110111010110000101001010000001101
111111111111111111111111111111111
